# Warranty & Liability
# To the extent permitted by applicable law and unless explicitly
# otherwise agreed upon, XLOG Technologies GmbH makes no warranties
# regarding the provided information. XLOG Technologies GmbH assumes
# no liability that any problems might be solved with the information
# provided by XLOG Technologies GmbH.
#
# Rights & License
# All industrial property rights regarding the information - copyright
# and patent rights in particular - are the sole property of XLOG
# Technologies GmbH. If the company was not the originator of some
# excerpts, XLOG Technologies GmbH has at least obtained the right to
# reproduce, change and translate the information.
#
# Reproduction is restricted to the whole unaltered document. Reproduction
# of the information is only allowed for non-commercial uses. Selling,
# giving away or letting of the execution of the library is prohibited.
# The library can be distributed as part of your applications and libraries
# for execution provided this comment remains unchanged.
#
# Restrictions
# Only to be distributed with programs that add significant and primary
# functionality to the library. Not to be distributed with additional
# software intended to replace any components of the library.
#
# Trademarks
# Jekejeke is a registered trademark of XLOG Technologies GmbH.
public
analyze_batch/0	testing/tracker
break/2	debug/default
breaking/2	debug/default
case/4	testing/runner
change_store/1	debug/custom
control_online/0	testing/tracker
cover/5	testing/tracker
cover_batch/1	testing/cover
cover_predicate/4	testing/tracker
cover_source/2	testing/tracker
cover_summary/1	testing/tracker
current_provable/1	inspection/provable
current_store/1	inspection/store
current_syntax/1	inspection/syntax
data_check/3	notebook/transform
debug/0	debug/default
debugging/0	debug/default
del_json/4	notebook/json
diagnose_online/0	testing/diagnose
dump/0	debug/dump
dump/1	debug/dump
elem_add_node/2	notebook/model
elem_attr/2	notebook/model
elem_get_attr/3	notebook/model
elem_get_name/2	notebook/model
elem_new/1	notebook/model
elem_node/2	notebook/model
elem_remove_node/3	notebook/model
elem_reset_attr/2	notebook/model
elem_set_attr/3	notebook/model
elem_set_name/2	notebook/model
frame_property/2	inspection/frame
friendly/0	debug/friendly
friendly/1	debug/friendly
generated/0	system/automatic
generated/1	system/automatic
get_json/3	notebook/json
goal_tracing/2	debug/custom
user:goal_tracing/2	testing/tracker
instrumented/0	debug/friendly
instrumented/1	debug/friendly
is_json/1	notebook/json
leash/1	debug/custom
micro_close/1	inspection/micro
micro_cont/1	inspection/micro
micro_new/2	inspection/micro
nobreak/2	debug/default
node_copy/2	notebook/model
node_get_key/2	notebook/model
node_get_parent/2	notebook/model
node_is_elem/1	notebook/model
node_is_text/1	notebook/model
node_read/2	notebook/serialize
node_read/3	notebook/serialize
node_set_key/2	notebook/model
node_term/2	notebook/serialize
node_term/3	notebook/serialize
node_write/2	notebook/serialize
node_write/3	notebook/serialize
nodebug/0	debug/default
noprotocol/0	system/protocol
nospy/1	debug/default
protocol/1	system/protocol
provable_property/2	inspection/provable
put_json/3	notebook/json
put_json/4	notebook/json
ref/4	testing/runner
reset_provable_property/2	inspection/provable
reset_store_property/2	inspection/store
reset_syntax_property/2	inspection/syntax
result/5	testing/runner
result_batch/1	testing/result
result_predicate/4	testing/runner
result_suite/2	testing/runner
result_summary/1	testing/runner
rule_ref/3	inspection/frame
runner_batch/0	testing/runner
runner_batch_debug/0	testing/runner
schema_digest/2	notebook/transform
schema_new/1	notebook/transform
select_json/3	notebook/json
set_provable_property/2	inspection/provable
set_store_property/2	inspection/store
set_syntax_property/2	inspection/syntax
sheet_check/2	notebook/transform
sheet_transform/4	notebook/transform
skip/0	debug/default
spy/1	debug/default
spying/1	debug/default
store_changing/1	debug/custom
store_property/2	inspection/store
stores/0	inspection/store
summary_batch/0	testing/summary
summary_batch/1	testing/summary
syntax_property/2	inspection/syntax
sys_at/0	system/mode
sys_atom_slash/2	inspection/notation
sys_call_goal/1	inspection/frame
sys_callable_colon/2	inspection/notation
sys_first_location/4	inspection/base
sys_in/0	system/mode
sys_indicator_colon/2	inspection/notation
sys_leashed_port/1	debug/default
sys_location/4	inspection/base
sys_name_flags/2	debug/default
sys_notrace_frame/1	debug/default
sys_out/0	system/mode
sys_provable_hash/3	inspection/base
sys_syntax_hash/3	inspection/base
tbreak/2	system/attach
tbreaking/2	system/attach
tclear/0	system/attach
tdebug/0	system/attach
tdebugging/0	system/attach
text/1	testing/tracker
text_get_data/2	notebook/model
text_new/1	notebook/model
text_set_data/2	notebook/model
tleash/1	system/attach
tnobreak/2	system/attach
tnodebug/0	system/attach
tnospy/1	system/attach
trace/0	debug/default
trace_goal/2	debug/custom
tracker_batch/0	testing/tracker
tracker_batch_debug/0	testing/tracker
tskip/0	system/attach
tspy/1	system/attach
tspying/1	system/attach
ttrace/0	system/attach
tup/0	system/attach
tvisible/1	system/attach
up/0	debug/default
visible/1	debug/default
with_input_from/2	system/charsio
with_output_to/2	system/charsio

